15 15
###############
#.............#
#.....p.......#
#.............#
#...........p.#
#.............#
#............p#
_........*....#
#.............#
#.............#
#.............#
#.............#
#..p..........#
#...........p.#
###############