7 7
#######
#.....#
#...m.#
_..mp.#
#.m...#
#.....#
#######
